rune meanings copied from https://forums.d2jsp.org/topic.php?t=53445450&f=21&o=0
most runes correspond to specific mantras(gnostic or hinduist).

El - Deity
Eld - Age
Tir - Expend
Nef - Metal
Eth - Thorn
Ith - Feast
Tal - Seed
Ral - Color
Ort - Waste
Thul - Flesh
Amn - Safety
Sol - Sun
Shael - Stone
Dol - Pain
Hel - Dead
Io - Moon
Lum - Exhaust
Ko - Hunt
Fal - Earth
Lem - Fruit
Pul - Strike
Um - Island
Mal - Dread
Ist - Belief
Gul - Flower
Vex - Suffer
Ohm - Power
Lo - Vision
Sur - Divine
Ber - Transform
Jah - God
Cham - Order 
Zod - Heaven
